county,precinct,bc,rv,vtp,dem,wf,constitution,independence,green,gop,american,libertarian,sttotal,clinton,castle,mcmullin,stein,trump,skewes,johnson,potustotal,dixon,bledsoe,scott,scarborough,senwritein,sentotal,cleveland,duncan,housewritein,housetotal
laurens,LAURENS 1,351,739,47.496617050067655,91,1,1,6,0,29,1,1,130,233,3,2,1,107,0,2,348,193,7,116,3,1,320,195,119,2,316
laurens,LAURENS 2,253,530,47.735849056603776,115,3,0,3,0,10,2,0,133,213,0,0,4,33,0,2,252,194,4,42,4,0,244,197,47,1,245
laurens,LAURENS 3,399,969,41.17647058823529,112,3,0,5,1,76,1,0,198,205,1,2,1,178,1,6,394,171,11,196,6,0,384,172,203,0,375
laurens,LAURENS 4,409,913,44.7973713033954,140,5,0,4,1,18,4,2,174,328,0,2,2,67,3,3,405,268,7,92,4,0,371,271,93,0,364
laurens,LAURENS 5,727,1392,52.22701149425287,65,2,0,3,1,126,1,2,200,260,2,7,3,438,0,11,721,206,15,482,2,1,706,204,491,0,695
laurens,LAURENS 6,561,1269,44.2080378250591,52,3,1,2,0,91,1,1,151,147,3,5,2,388,0,7,552,114,10,411,3,3,541,119,414,1,534
laurens,BAILEY,553,978,56.5439672801636,70,10,0,8,2,107,2,0,199,194,3,8,1,338,0,5,549,167,9,350,3,2,531,154,373,0,527
laurens,TRINITY RIDGE,759,1376,55.15988372093024,98,10,0,8,0,128,1,1,246,254,4,6,0,473,0,13,750,217,19,485,4,0,725,220,501,0,721
laurens,WATTSVILLE,681,1270,53.62204724409448,72,14,1,10,1,159,5,2,264,173,4,8,3,481,2,8,679,161,16,471,6,1,655,139,510,2,651
laurens,BARKSDALE-NARINE,487,936,52.029914529914535,70,7,1,3,2,98,0,1,182,144,2,5,2,331,0,1,485,134,6,321,2,2,465,120,342,0,462
laurens,MADDENS,672,1148,58.536585365853654,73,12,0,7,0,137,3,1,233,166,2,3,3,481,3,4,662,160,15,467,9,0,651,147,499,0,646
laurens,CLINTON 1,711,1427,49.82480728801682,132,6,0,9,3,125,2,3,280,289,3,9,4,383,3,13,704,248,15,395,4,0,662,233,434,1,668
laurens,CLINTON 2,718,1540,46.62337662337662,98,1,2,3,0,73,0,4,181,291,4,19,3,358,1,23,699,222,10,457,0,1,690,228,464,1,693
laurens,JOANNA,1037,1681,61.68947055324212,106,11,0,10,4,252,4,0,387,221,2,8,8,774,0,15,1028,232,21,731,9,0,993,193,798,1,992
laurens,LYDIA MILL,587,1257,46.69848846459825,155,12,1,8,1,63,5,1,246,347,3,2,2,220,2,8,584,304,7,235,4,2,552,283,262,2,547
laurens,MOUNTVILLE,405,652,62.11656441717791,60,1,1,4,0,85,0,1,152,141,4,2,3,245,0,5,400,115,7,262,2,0,386,111,267,1,379
laurens,CLINTON 3,870,1333,65.26631657914479,73,7,1,4,0,169,2,1,257,218,0,10,4,613,1,11,857,175,13,650,6,0,844,157,687,0,844
laurens,JONES,844,1449,58.247066942719115,146,8,0,7,1,253,6,0,421,265,5,2,4,540,2,16,834,254,10,550,12,0,826,249,555,1,805
laurens,OWINGS,487,747,65.19410977242302,77,4,1,2,0,124,3,2,213,134,3,1,3,323,1,12,477,132,2,325,3,0,462,121,338,0,459
laurens,GRAY COURT,707,1255,56.33466135458167,130,11,0,3,3,140,3,1,291,264,3,4,5,413,2,9,700,232,6,396,10,0,644,217,421,1,639
laurens,GREENPOND,992,1528,64.92146596858639,84,11,0,7,1,292,4,5,404,172,1,7,3,783,0,18,984,176,32,748,6,0,962,152,799,0,951
laurens,COOKS,1264,2339,54.04018811457888,194,13,1,12,5,384,4,8,621,351,8,10,12,847,0,28,1256,349,42,837,10,3,1241,345,874,3,1222
laurens,YOUNGS,710,1158,61.3126079447323,43,4,0,10,1,239,4,0,301,99,1,10,1,574,3,15,703,85,16,575,10,2,688,77,605,2,684
laurens,ORA-LANFORD,540,914,59.08096280087527,88,3,2,6,1,114,2,1,217,164,8,3,0,352,1,7,535,143,19,355,3,0,520,141,375,0,516
laurens,LONG BRANCH,729,1167,62.46786632390745,53,8,0,5,2,167,5,1,241,127,4,9,1,566,1,9,717,124,12,564,4,0,704,97,603,1,701
laurens,CROSS HILL,958,1573,60.90273363000635,154,10,0,4,0,243,7,1,419,347,4,7,3,576,4,7,948,318,18,571,11,0,918,301,609,0,910
laurens,WATERLOO,892,1538,57.99739921976593,103,7,2,5,0,240,8,1,366,287,2,4,3,577,1,10,884,245,17,589,9,0,860,239,604,0,843
laurens,MARTINS-POPLAR SPRINGS,441,670,65.82089552238806,20,2,0,0,1,137,4,0,164,53,1,1,0,369,0,14,438,65,15,338,7,0,425,51,374,0,425
laurens,EKOM,349,599,58.263772954924875,14,3,0,2,0,99,1,2,121,48,3,2,1,281,0,10,345,56,12,266,4,0,338,44,290,0,334
laurens,MOUNT OLIVE,610,1058,57.655954631379956,26,3,0,2,1,240,3,1,276,76,1,0,1,519,1,9,607,83,7,488,2,1,581,66,516,1,583
laurens,HICKORY TAVERN,1311,2204,59.48275862068966,77,12,2,12,4,392,7,7,513,193,19,7,12,1046,0,21,1298,194,34,1031,9,1,1269,160,1098,1,1259
laurens,PRINCETON,171,277,61.73285198555957,11,0,0,1,1,52,2,1,68,17,0,4,2,145,0,2,170,25,7,126,3,0,161,18,145,0,163
laurens,BREWERTON,312,453,68.87417218543047,10,2,1,3,1,105,0,0,122,32,2,5,3,263,0,3,308,29,9,259,3,0,300,21,272,0,293
laurens,CLINTON MILL,717,1465,48.9419795221843,221,20,2,10,2,83,7,1,346,453,2,2,5,236,1,7,706,394,11,238,12,2,657,359,279,0,638
